44 27
00000000000#00000000000000000000000000000000
00000000000#000000000000000000000000000s0000
00000000000#00000000000000000000000000000000
00000000000#####0000000000000000000000000000
00000000000000000000000000000000000000000000
0000000000000000000000#####00000000000000000
00000##000#####000#####000#00000000000000000
000000#000#000000000000000#00000000000000000
000000#000#000000000000000#00000000000000000
000000#000#000000000000000#00000000000000000
000000#000###0000000000000#####0000000000000
000000#00000#0000000000000000000000000000000
000000#00000#0000000000000000000000000000000
000000#00000#00000000000000000000000########
000000#0000000000000000000000000000000000000
000000#000000000000##00000000000000000000000
000000#000000000###0000000000000000000000000
000000###########0000###00000000000000000000
00000000000000000000000####00000000000000000
00000000000000000000000000#####0000000000000
000000000000000000000000000000#0000000000000
000000000000000000000000000000#0000000000000
00s000000000000000000000000000####0000000000
00000000000000000000000000000000000000000000
00000000000000000000000000000000000000000000
00000000000000000000000000000000000000000000
00000000000000000000000000000000000000000000
